 : q
0: w
1: e
2: r
3: t
4: y
5: u
6: i
7: o
8: p
9: a
A: s
a: d
B: f
b: g
C: h
c: j
D: k
d: l
E: ;
e: '
F: z
f: x
G: c
g: v
H: b
h: n
I: m
i: ,
J: .
j: /
K: Q
k: W
L: E
l: R
M: T
m: Y
O: U
o: I
P: O
p: P
Q: A
q: S
R: D
r: F
S: G
s: H
T: J
t: K
U: L
u: ;
V: Z
v: X
W: C
w: V
X: B
x: N
Y: M
y: ,
Z: .
z: /